abate:v.减少      
abhor:v.憎恨      
abject: a.可怜的
abjure: v.发誓弃绝    
abode: n.住处      
abominable: a.讨厌的 
abridge: v.缩短    
abrupt: a.突然的
absurd: a.荒谬的     
abundant: a.富裕的  
accidental: a.突然的 
acclaim: v.宣称    
accompany: v.陪伴  
account: v.计算    
accountable: a.负责任的 
accusation: n.指责 
acre: n. 亩
acrid: a.尖酸的       
acumen: n.聪明,敏锐   
adage: n.格言      
adamant: a.坚定的   
adaptable: a.可适应的  
addled: a.头脑混乱的     
adhere: v.黏附     
admiring: a.敬佩的   
admonish: v.警告
adroit: a.敏捷的
adulation: n.谄媚
adversary: n.对手,敌手
affable: a.和蔼的    
affection: n.慈爱,感情  
affluent: a.滔滔不绝的, 丰富的，富饶的
agenda: n.议程 
aggrandize: v.扩大 
aggravation: n.恶化,恼怒 
aggressive: a.挑衅的,积极的
aghast: a.吓人的   
agile: a.敏捷的       
agitated: a.被激怒的
agriculture: n.农业 
aimless: a.漫无目的的  
airy: a.空气的,幻想的  
alert: a.机警的      
alias: n.别名,化名      
alien: n.外星人      
align: v.排成一排      
allegation: n.宣誓 
allergic: a.过敏的 
aloof: a.冷漠的      
alter: v.改变      
alternate: a.轮流的  
altimeter: n.高度计
altitude: n.高度
amass: v.积聚      
ambiguous: a.模棱两可的
ambition: n.雄心壮志   
ambitious: a.有雄心的  
ambulatory: a.可走动的  
amenable: a.和蔼的   
amend: v.修补      
amiable: a.和蔼的    
ammunition: n.军火,弹药  
amoral: a.与道德无关的     
amorphous: a.无定形的 
amphibian: n.两栖动物 
ample: a.大的,充分的      
amplify: v.扩大
amuse: v.逗乐      
anarchist: n.无政府主义者
ancient: a.古代的    
anesthetic: n.麻醉剂
angelic: a.天使般的
anguish: v.使苦恼
animosity: n.敌意  
annoy: v.使苦恼     
annulment: n.废除,取消  
antagonist: n.敌手,对手 
antagonistic: a.敌对的  
antediluvian: a.史前的  
anthologist: n.诗集编者
anthology: n.诗集
antidote: n.解药      
antique: a.古代的       
antiseptic: a.抗菌的
antithesis: n.对照,对抗    
antitoxin: n.抗毒素     
anxiety: n.焦虑       
apartment: n.房屋一间
apathy: n.冷漠        
apiary: n. 蜂房
apparatus: n. 器具     
apparition: n.幽灵   
appeal: v.吸引        
applause: n.条款
appliance: n.应用     
appreciation: n.欣赏  
apprehension: n.焦虑  
approach: v.接近      
apse: n.穹顶 
apt: a.适合的,有能力的     
aquamarine: a.蓝绿色的
aquatic: a.水生的
aqueduct: n.水渠
archaic: a.古代的
architectural: n. 建筑
ardor: n.狂热,热情     
arid: a.干燥的       
armor: n.盔甲
aroma: n.香气
arrogant: a.骄傲的  
articulate: a.清楚发音的  
artificial: a.虚假的  
ascend: v.上升 
assailable: a.可攻击的(有弱点的) 
assault: v.攻击     
assemble: v.集合    
assert: v.断定     
assessment: n.评价  
assist: v.帮助    
astound: v.惊吓    
astronomy: n.天文学
athletic: n. 运动员    
atmosphere: n.气氛,氛围  
attentively: adv.留意地 
attic: n.阁楼
attorney: n.律师 
attractive: a.吸引人的  
atypical: a. 非典型的  
audible: a. 可以听到的
audit: v. 审计
auditorium: n. 礼堂 
auditory: a.听觉的 
augury: n. 预言,征兆   
auspicious: a. 吉兆的  
austere: a. 简朴的     
authentic: a. 真正的   
authoritative: a. 权威的
automatic: a. 自动的   
autopsy: n. 解剖学,解剖
avarice: n. 贪婪     
avert: v. 避免       
avian: a. 鸟类的    
awkward: a. 笨拙的     
axe: n. 斧头
babble: v. 牙牙学语
bacterium: n. 细菌
bait: n. 鱼饵
baked: a.烘烤的  
baker: n. 烘烤师
ballet: n. 芭蕾
ban: v. 限制         
bandage: n. 绷带     
banish: v.驱逐      
banker: n. 银行家  
bark: n. 树皮
barter: n. 物物交换      
bass: n.低音
bastion: n. 堡垒     
bat: n. 蝙蝠;球拍
batter: n.打手 
beak: n. 鸟嘴
beam: n.一束光;横梁
befriend: v.与人为善    
beget: v.产生,引起    
beggar: n. 乞丐      
belie: v. 掩饰       
believable: a. 可信的  
bellicose: a. 好斗的   
belligerent: a.好斗的 
benevolent: a. 慈善的  
beret: n. 贝雷帽
berry: n.草莓
betray: v. 背叛,暴露  
beverage: n. 饮料    
biased: a. 有偏见的   
billboard: n. 布告栏
biodegrade: v. 生物降解
biscuit: n. 饼干
bite: v. 轻咬        
bitter: a. 苦的;尖刻的 
bizarre: a. 奇怪   
blade: n. 刀锋
blast: n. 爆炸;一阵
blatant: a. 明显的     
bleak: a. 漏雨的;阴郁的   
blender: n.搅拌器
bliss: n. 极其幸福      
blithe: a. 快乐的     
bloated: a. 膨胀的    
blockage: n. 障碍   
blooming: a. 蓬勃发展的
blossom: n. 开花
blueprint: n. 蓝图
bluff : v.虚张声势     
boar: n. 公猪,野猪
boast: v. 夸张      
boisterous: a. 喧闹的
bolster: v. 支持
bolt: n. 门闩
boon: n. 恩惠       
bore: n. 令人讨厌;令人讨厌的人   
boulder: n. 大圆石
boundary: n. 边界
bounty: n. 慷慨;恩惠     
brazen: a. 黄铜的;厚颜无耻的
breach: n. 裂口     
breed: v. 养育      
breeze: n. 微风
brevity: n. 简单    
brick: n. 转头
bridle: n. 缰绳
briefcase: n. 公文包
broccoli: n. 绿菜花
brush off: 刷掉;打发走
brutal: a. 野蛮的     
bubble: v. 冒泡
buckle: n. 皮带扣
bud: n. 花蕾
budget: n. 预算
buffer: n. 缓冲,缓冲区
buffet: n. 自助餐
buffoon: n. 丑角,缺乏教养之人    
bulb: n. 植物的茎;灯泡 
bur: n. 芒刺
burial: n. 埋葬     
butcher: n. 屠夫
butter: n. 黄油 
butterfly: 蝴蝶 
buttress: v. 支持
cabinet: n. 壁橱
cacophony: n.声音刺耳  
cafeteria: n. 自助餐厅
caffeine: n. 咖啡因
camel: n. 骆驼
camouflage: v. 伪装 
can: n. 罐 
canal: n. 运河
candid: a. 坦白的     
candor: n. 坦白     
canine: a. 狗的 
cantaloupe: n. 哈蜜瓜
cantankerous: a. 爱争吵的
canter: v. 慢跑
canvas: n. 油布 
capable: a. 有能力的    
capital: n. 资本    
caprice: n. 任性    
capture: v. 抓获    
cardinal: a. 重要的
caricature: n. 讽刺画
carnival: n. 嘉年华会       
carpenter: 木匠 
cartographer: n. 制图师
carved: a. 刻字的     
cashier: n. 出纳
cassette: n. 磁带
cast out: 扔出,抛弃   
castigate: v. 严厉斥责
casual: a. 随便的     
catastrophe: n. 大灾难 
caterpillar: n. 毛毛虫
caustic: a. 腐蚀的    
cautious: a. 谨慎的   
cavern: a. 大洞穴
censor: v. 审查     
censure: v. 指责    
centralized: a. 集中的 
ceramics: n. 制陶术
chaff: v. 开玩笑,揶揄;n. 谷糠  
champion: v.支持;n. 冠军    
chaos: n. 混乱      
chapped: a. 裂开的, 有裂痕的
charitable: a. 慈善的 
charming: a. 有魅力的   
chart: n. 图表
chase: v. 追逐      
cheerless: a. 无精打采的  
cheese: n.奶酪
chef: n.厨师  
cherry: n. 樱桃
chew: v.拒绝
chide: v.斥责      
childish: a. 像小孩子一样的   
chisel: n. 凿子
choir: n. 唱诗班
choke : v.窒息
chord: n. 琴弦
choreographer: n.舞蹈编排家
chorus: n.合唱
chronic: a.慢性的    
circus: n. 马戏团
civility: n. 礼貌,端壮    
clamor: n.喧闹     
clank: n. 发当啷声
clap: n.鼓掌
clarify: v.澄清    
clarinet: n. 竖笛,单簧管
clash: v.碰撞      
clause: n.条款,款项
claw: n.爪子
clay: n. 粘土
cliff: n.悬崖
clip: n.别针,剪子
clipboard: n. 剪贴板
clog: n. 阻塞
clot: n.凝结,粘块 
clue: n. 暗示
clumsy: a.笨拙     
coarse: a.粗糙的     
cocoon: n. 茧
cod: n. 鳕鱼
coddle: n.溺爱     
cogent: a.有说服力的
collaboration: n.合作 
collage:  n. 抽象派美术
collar: n. 衣领
collegial: a. 学院的  
collide: v.碰撞    
colorful: a.多姿多彩的   
colossal: a. 巨大的   
combustion: n. 燃烧
comical: a.滑稽的
comma: n.逗号 
commence: v.开始    
commentator: n.评论员
commotion: n. 骚动,暴乱   
compact: a.紧密的    
companion: n. 伙伴  
compassion: n.同情 
compensate: v.补偿  
competent: a.能胜任的   
complain: v.抱怨    
complement: n.完成  
compliment: n. 恭维  
compose: v.组成;作文;作曲     
comprehension: n.理解 
concealing: a.取消的  
conceited: a.自大的   
conciliate: v.抚慰  
conciliating: a.抚慰的
conclude: v.作结论    
concrete: a.具体的;n.混凝土
concur: v.同意      
condemn: v. 谴责
condescend: v.弯腰  
condescending: a. 以恩惠的态度对待
condone: v. 原谅     
confide: v.自信     
confident: a.自信的   
confinement: n. 限制
confirmation: n.确定 
conflagration: n. 大火灾  
conflict: n. 小冲突    
conform: v. 遵守     
confuse: v.使迷惑     
congenial: a. 和蔼的   
congenital: a.天生的  
congested: a.拥挤的   
congregation: n. 聚集
consequence: n.结果 
conservation: n. 保护,保守 
conservative: a. 保守的
considerate: a.相当大的  
consistency: n.连续性  
conspicuous: a.明显的  
constant: a.坚定的     
constellation: n.星座 
consumption: n.消费   
container: n. 容器     
contaminate: v.污染
contemplate: v.聚焦   
contemporary: a.当代的  
contempt: n. 轻视,轻蔑      
contend: v.竞争
continuous: a.连续的    
contort: v.折磨       
contour: n.轮廓       
contract: v.收缩;n.合约      
contradiction: n. 矛盾 
contribute: v.贡献    
convene: v. 聚集       
convenient: a.便利的    
converse: a. 相反的,逆向的
convict: v.宣告…有罪 
convoluted: a.费解的    
cooperate: v.合作     
copious: a. 丰富的
coral: n.珊瑚
corporal: a.肉体的,身体的
corroboration: n.合作 
corrupt: a. 腐败的
counselor: n.顾问     
counterfeit: n.赝品   
courageous: a.有勇气的    
court: v. 献殷勤
courteous: a. 有礼貌的
cowardly: adv.胆怯地
crack: v.打碎;解压
crafty: a. 狡猾的        
craggy: a. 多峭壁的
cramped: a.促狭的        
crane: n. 鹤,起重机
crash :n.碰撞        
crass: a. 粗鲁的,愚钝的         
crawl: v.爬行  
crayon: n. 蜡笔
credible: a.值得相信的      
credulous: a.轻信的     
crew: n.船员   
criminal: n.犯罪分子
criminology: n.犯罪学
cringe: v. 畏缩,谄媚
critical: a.批评的;重要的      
criticism: n.批评     
critique: n.批评
crucial: a.重要的       
crude: a.粗糙的         
crumble: v. 崩溃,弄碎       
crust: n.外壳
cuff: n.小牛  
culpable: a.有罪的      
culprit: n.犯人
cultivation: n.培育
cunning: a.狡猾的       
curator: n.博物馆馆长 
curiosity: n.好奇心
curse: v.诅咒      
curve: n.曲线      
cushion: n. 垫子,橡皮软垫   
cygnet: n. 小天鹅
cylinder: n.圆柱体
damp: a.潮湿       
dawdle: v. 游手好闲,混日子    
dazzling: a.耀眼的   
deadly: a.致命的     
dearth: n.缺乏     
debunk: v.揭露     
decay: v.腐烂      
deceit: n.欺骗     
deceive: v.欺骗    
deceleration: n.减速
decibel: n.分贝
decipher: v.解密
decline: v.下降    
decomposition: n.分解 
decongest: v. 解除充血      
decorate: v.装饰         
decrepit: a. 破旧的,衰老的
defiant: a.违背的    
defile: v. 弄脏,污损     
definition: n.定义 
defoliate: v.使落叶  
deform: v.使变形     
dejected: a.沮丧的   
delay: v.延迟      
delectable: a. 快乐的,可喜的
delegation: n.代表 
delete: v.消除     
delicate: a.精细的   
delicious: a.可口的,美味的  
delight: a.高兴的
delinquent: n.流氓;a.有过失的 
deluge: n. 大洪水,泛滥
demean: v.贬低     
demeanor: n.行为   
democratic: a.民主的 
denigrate: v. 使变黑,玷污
denounce: v.谴责   
dense: a.密度大的,稠密的      
dentist: n. 牙科医生
deodorize: v. 除臭,防臭  
departure: n.离开  
dependent: a.依靠的  
deplete: a.清空的    
deplore: v.哀求    
deport: v.驱逐     
depress: v. 使沮丧    
deprive: v.剥夺    
derogatory: a. 贬损的
descent: n. 降落,家系
desecrate: v.使干燥  
desert: n.沙漠;v.遗弃
deserve: v.值得    
desiccated: a.干的,粉状的
desolate: a. 荒凉的   
despair: a.绝望的    
desperate: a.绝望的  
despise: v.轻视    
despondent: a.失望的 
dessert: n. 甜食
destitute: a. 困穷的,缺乏
destructive: a.破坏性的 
detailed: a.详细的   
deter: v.威慑      
deteriorate: v. 恶化  
detour: n.绕路      
detrimental: a.有害的 
deviation: n. 偏差   
device: n.装备      
devise: v.设计      
devoted: a.专一的     
devout: a. 虔诚的
dexterity: n.敏捷   
dexterous: a.敏捷的   
dialogue: n.对话    
dice: n. 骰子
diffuse: v.解除(炸弹)     
dignify: v.增威严,使高贵     
diligent: a.勤奋的    
dim: a.昏暗的         
diminish: v.减少    
din: n.喧嚣         
dine : v. 用正餐,进餐       
dinosaur: n.恐龙 
diplomat: n.外交家,外交官
disadvantaged: a.劣势的 
disagreement: n.意见不统一  
disapproval: n.不同意   
disarm: v.解除武装        
disassemble: v.解散
disastrous: a.危害大的    
discard: v.遗弃       
discourage: v.使士气低落    
discourse: n.演讲.论文    
discredit: v.怀疑,损害...的信用   
discursive: a. 散漫的
disdain: v.蔑视  
disguise: v.伪装    
disintegration: n.分解
dismal: a.沮丧的      
dismantle: v. 拆除...的设备,分解   
dismay: v.沮丧
dismiss: v.解雇,解散,不相信     
dismissal: n. 免职,解雇
disobedient: a.不遵守的  
dispersion: n. 散布
disruptive: a. 捣乱的,破坏性的  
dissemble: v.分散   
disseminate: v.分散,消散 
dissolved: a.溶解的
dissonance: n.不谐和音,不一致   
distinct: a.不同的    
distinguished: a.出名的
ditch: n. 沟渠       
diversity: n.多样性  
divert: v.转移     
divulge: v. 泄露,暴露    
docile: a.温顺的     
dock: n. 码头,船坞       
dogged: a.尾随的     
dolphin: n. 海豚
domicile: n. 住所,住宅   
dominate: v.占据   
donate: v.捐款    
donor: n. 捐赠人     
dormant: a.静止的   
dossier: n. n. 档案材料   
dot: n.圆点
doubtful: a.怀疑的   
dough: n.生面团
downtrodden: a. 受压迫的
doze: v. 打瞌睡,假寐      
dreary: a. 沉闷的    
driftwood: n. 流木,浮木
drill: v.训练
drooping: a. 下垂的,无力的  
drop: n.小水滴
drought: n.干涸
drowsy: a. 昏昏欲睡的    
drummer: n. 鼓手
dubious: a.怀疑的   
dull: a.乏味的  
duplicate:v.复制  
dwindle: v.减少   
dye: n. 染料,染色       
dynamite: n. 炸药
eager: a.急切的
earnest: a.认真的
ebullient: a.兴奋的
ecstasy: n.狂喜   
edible: a.可食的
efficiency: n.效率
elaborate: a.精巧的;v.精工制作 
elation: n.喜出望外   
elect: v.选举     
electricity: n.电
elegant: a. 优雅的,精美的
elegy: n. 悲歌,哀歌
element: n.元素   
elevate: v.提升   
elevator: n.电梯
eliminate: v.消除 
elongate: v.延长  
elongated: a.延长的 
elusive: a.费解的   
emergency: n.效率 
emotional: a.动感情的 
empathy: n.移情作用
emphasize: v.强调 
emphatic: a.强调的  
emu: n. 食火鸟
emulate: v.模仿   
enclosure: n. 围墙,围绕
encompassed: a.被包围的
endanger: v.使陷入困境  
endure: v.忍受   
energetic: a.活跃的  
enfold: v.折叠   
engage: v.卷入    
enigmatic: a.谜的
enjoyable: a.享受的
enlarge: v.扩大  
enlighten: v. 启迪
enormous: a. 巨大的
ensign: n. 舰旗
entertaining: a.娱乐性的
enthusiastic: a.热情的 
entrust: v.相信   
entry: n.键入;条款     
envelope: n.信封
epic: n.史诗
epoxy: n. 环氧基树脂     
equality: n.平等   
equalization: n. 均衡,均等
equine: a马的,似马的    
equitable: a.相等的  
equivocator: 说话模棱两可的人
eradicate: v.根除 
erosion:n. 侵蚀
erratic: a. 偏离的,固执的   
erroneous: a.错误的 
eruption: n.喷发
esoteric: a.难懂的，秘传的
essay: n.议论文
essential: a.必要的 
esteem: v.尊敬
eternity: n.永远   
ethereal: a.空气的,天上的
etiquette: n. 礼仪,礼节
eulogy: n.赞词    
evade: v.逃避     
evening gown: n. 女子夜礼服
exaggeration: n. 夸张
exalt: v.赞美     
excavate: v.挖出  
exceed: v.超过    
excess: n.过度    
excessive: a.过度的 
excitable: a.兴奋的  
exclamation: n.喊出
exclude: v.排除   
executive: a.执行的
exempt: a.免除的
exhaust: v.耗尽   
expedition: n.短途旅行 
expel: v.驱逐      
expert: n.专家     
explicit: a.明确的，清楚的
explosion: n. 爆炸,爆发     
expose: v.暴露     
expunge: v.擦掉,删掉     
external: a.外部的
extraneous: a.外来的 
extraordinary: a.非凡的
extra: n.附加品
extravagance: n.浪费
extreme: a.极度的    
extremity: n.极限  
extricate: v. 使解脱,救出
extroverted: a.外向的
exuberant: a.繁茂的  
fabric: a.纤维的
fabrication: n.捏造
fabulous: a. 传说的,无根据的
facile: a.容易做的
facilitate: v.使便利
faithful: a.忠诚的    
fake: 假的
fallacy: n.谬误    
fallow: a. 休耕的     
falsehood: n.错误   
falsification: n.捏造 
fame: n.荣誉       
famine: v.挨饿
famished: a.挨饿的
fancy: n. 想像力,幻想
fantastic: a.极好的  
fascinating: a.有趣的 
fatal: a.致命的      
fathom: v.探寻
fatigue: n.疲劳    
faucet: n.水龙头
favor: n.帮助      
favorable: a.有利的，赞成的，良好的  
feast: n. 宴会,酒席       
feather: n. 羽毛
feeble: a.虚弱的      
feign: a.假的
feline: a. 猫科的
fence: n. 围墙,剑术
ferment: n.v.发酵,动乱
ferocity: n.生气    
fertile: a.肥沃的
festival: a.节日的    
fetid: a. 有恶臭的,臭的
fib: n. 小谎,一击
fickle: a. 变幻无常的,浮燥的
fiction: n.科幻小说     
fidelity: n. n. 忠实,诚实
fiend: n. 魔鬼,邪神
fierceness: n. 凶恶,残忍  
fiery: a. 炽热的,热烈的       
fin: n. 鳍,鱼翅  
finalize: v. 使结束,使完结    
financial: a.金融的   
finicky: a. 苛求的     
fireplace: n. 壁炉
flashy: a. 闪光的,一瞬间       
flat: a.平的        
flatter: v.谄媚
flexible: a. 灵活的,易弯曲的  
floating: a.漂浮的    
flock: 羊群
flora: 植物
florist: n. 花匠,花商
flour: n. 面粉
fluid: n.液体;a.液体的      
foe: n. 敌人,仇敌        
foible: n.小缺点     
foment: v. 煽动     
forethought : n. 考虑将来,深虑
forewarning: a. 预先警告的  
forge: v.锻打      
forgivable: a.可原谅的
fork: n.刀叉
formidable: a.可怕的  
formula: n.公式     
forthcoming: a. 即将到来的
fortify: v. 设要塞,加强    
fortunate: a.好运的   
fossil: n.化石 
foundation: n.基础   
founder: n. 创立者     
fountain: n. 喷泉
fraction: n分数    
fractious: a. 易怒的,脾气不好的
fragile: a.易碎的     
fragrant: a.香的    
frail: a.脆弱的       
frame: n.框架
frank: a.直率的       
freezer: n. 冰库,冰箱
fret: v. 烦恼,不满        
frisky: a. 活泼的,快活的      
frivolous: a.轻佻的   
frown: v.皱眉头 
frozen: a.冷的,冻的      
frugal: a.节俭的
fruitful: a.硕果累累的    
furious: a.生气的,愤怒的     
fuss: n.大惊小怪        
futile: a.无用的      
galaxy: n. 银河,一群显赫之人      
gallant: a.勇敢的     
galley: n. 厨房
gallop: n. 疾驰,飞奔
gauge: n.精确计量
gavel: n.法官用的小木槌
gem: n. 宝石  
generosity: n.慷慨
generous: a.慷慨的    
genteel: a. 文雅的,有教养的     
genuine: a.真正的，真实的 
germ: n. 微生物,细菌
ghastly: a.像鬼一样的     
gigantic: a.巨大的    
girder: n.桥梁
glacier: n. 冰河,冰川
glance: v.一瞥
glib: v.油嘴滑舌的        
gloomy: a.阴郁的      
glorification: n.荣誉 
glorious: a.光荣的 
glove: n. 手套
gluttonous: a.贪吃的
gluttony: n.贪吃
gnarled: a. 树木多瘤节的     
goalie: n. (足球等运动的)守门员
goat: n. 山羊
gosling: n. 小鹅,年轻无知的人
gossip: n. 闲聊
graceful: a.优雅的   
gracious: a.亲切的,高尚的     
grain: n.稻子       
granite: n. 花岗石
grape: n. 葡萄
graphite: n. 黑铅,石墨
grasping: a. 贪心的,贪婪的    
grasshopper: n. 蚱蜢
grateful: a.感激的
grave : a.悲伤的      
graze : v.盯住      
greed: n.贪婪       
greedy: a.贪婪的
gregarious: a.群居的 
grieve: v.为…悲伤      
grim: a.憔悴的        
grimace: v. 扮鬼脸
grime: n. 污垢,污物
grin: v.露齿而笑       
grizzly: a. 灰(白)色的,灰白的
groan: v.呻吟
grocery: n.小商品店
groomer: n. 马夫,新郎
ground hog: 土拨鼠
growl: n. 吠声,不平      
grumpy: a. 性情乖戾的,脾气暴躁的
guard: v.保卫:       
guile: n. 狡猾:        
guilt: n.负罪:       
gullible: a.轻易受骗的    
gully: n. 小峡谷,排水沟
gurgle: n. 汨汨地流      
gusty: a. 阵阵猛急的,突发的     
gymnast: n. 体操运动员
gyroscope: n. 陀螺仪
habitual: a.习惯的   
haiku: n.日本的一种诗体
hallow: v. 使...神圣,视为神圣     
halt: v.停止       
hammer: v.阻碍
haphazard: a.偶然的
hapless: a.运气差的    
harbinger: n.先驱者   
harden: v. 变硬,使...坚强     
hardy: a.坚强的，勇敢的    
harem: n. 闺房
harmonize: v.使和谐  
harp: n. 竖琴
harsh: a.严厉的      
hasten: v.加速
hatred: a.憎恨的     
haughty: a.高傲的    
hazy: a. 朦胧的,模糊的       
headstrong: a. 顽固的,刚愎的
hearty: a. 诚恳的,热烈     
heighten: v.增高,提高   
heinous: a.憎恨的
helmet: n.头盔     
hem: n. 边缘
herb: n.草
herbivorous: a.植食动物的
hermit: n.隐士      
heterogeneous: a. 异种的,异质的
hexagon: n. n. 六角形
hibernate: v. 冬眠
hilarious: a.高兴的
hinder: v.阻碍      
hippopotamus: n. 河马
historical: a.历史的 
hoax: v.哄骗       
hockey: n. 曲棍球
homage: n. 敬意      
homogenize  
honey: n.蜂蜜;a.亲爱的
honeycomb: n. 蜂窝
honorable: a.尊重的   
hood: n. 头巾
hop: v.单脚跳跃
horrify: v.使害怕     
horror: n.恐惧
household: n.家庭   
humanitarian: a.人性的
humble: a.谦逊的      
humid: a.潮湿的       
humility: n.谦逊    
hummingbird: n. 蜂鸟
humongous: a. 其大无比的
hurl: n. 用力的投掷        
husk: n. 外壳,皮
hydration: n. 水和
hygienic: a. 卫生学的, 卫生的
hyperactive: a. 极度活跃的
hyperbole: n.夸张 
hypothetical: a.假设的 
hysteria: n.歇斯底里
hysterical: a.歇斯底里的  
identical: a.相同的   
identification: n.相同 
idle: a.懒散的
igneous: a. 火的,似火的
ignorance: n.无知   
illegible: a.不合法的
illumination: n.照明,阐释  
illusion: n.幻想      
illustrate: v.举例    
imaginary: a.想象的     
imagination: n.想象   
imbue: v.灌输         
imitate: v.模仿       
immaculate: a.洁白的
immature: a.不成熟的      
imminent: a.即将到来的      
immortal: a.不朽的 
immune: a.免受…的        
impeccable:a. 无瑕疵的
impede: v.阻碍        
impediment: n.阻碍    
impending: a.即将到来的     
impenetrable: a.不能穿透的  
imperfection: n.不完美  
imperious: a.傲慢的      
implicate: v.使…绕进去    
imply: v.暗示         
imposing: a.强加的，威风的，壮观的      
impractical: a.没有实际用处的   
imprudent: a.粗鲁的     
impulsive: a.激动的     
inalienable: a.不可疏远的;亲近的   
inane: a. 空虚的,愚蠢的
inanimate: a.没有生气的     
inappropriate: a.不合适的 
inarticulate: a.不清楚的  
inaugurate: v. 开创,举行     
inauspicious: a.凶兆的  
inborn: a.与生俱来的        
incarceration: n. 下狱,监禁
incessant: a.不停歇的     
incinerate: v.焚化,焚烧     
incite: v. 刺激,激励        
incline: v.倾向       
incomprehensive: a.无法理解的 
inconclusive: a.不包含的  
inconsiderate: a.不关心别人的 
inconsistent: a.不连续的  
incredible: a.不相信的    
incredulous: a.不轻易相信的
incremental: 增量的,增加的   
indecent: a.不体面的      
indecision: n.没有决断力    
indefatigable: a.不知疲倦的 
independent: a.独立的   
indicate: v.暗示      
indication: n.暗示    
indict:v.控诉
indifference: n. 不关心  
indignation: n.极其愤怒
indistinguishable: a. 不能区别的
inedible: a.不能吃的      
ineffective: a.无效的   
inertia: n.惯性,惰性       
inevitable: a. 不可避免的    
inexhaustible: a. 用不完的
infamous: a.无耻的      
infect: v.感染        
infection: n.感染 
inferior: a.低劣的      
infiltration: n. 浸润
inflated: a.膨胀的      
informed: a.无所不知的      
ingenious: a.精巧的，巧妙的     
ingredient: n.元素
inhumane: n. 不人道的      
initiate: v. 开始      
inject: v. 注射
injured: a. 受伤的      
injurious: a. 有害的    
innate: a.天生的       
innocent: a. 无辜的
innocuous: a.无害的    
inopportune: a.不合时宜的  
insanity: n.不正常,疯狂
insightful: a.有洞察力的   
insignificance: n.不重要 
insinuate: v.暗示,暗指
insipid: a.无聊的
insomnia: n.失眠症
instigate: v.煽动    
insult: v.污染       
intangible: a.无形的
integrity: n.正直
intelligent: a.聪明的  
intense: a.强烈的      
internal: a.内部的
interpretation: n.解释 
interruption: n.打断   
intervene: v.干涉    
inundate: v.淹没,泛滥 
investigate: v.调查   
involuntary: a.非自愿的   
invulnerable: a.不易受攻击的  
ire: n.愤怒           
irk: v.使厌倦
ironic: a.讽刺的        
irrelevant: a.不相关的    
irrigate: v.灌溉 
irritate: v.激怒      
isolate: v.孤立        
ivory: a.乳白色的
jade: n.玉
jail: n.监狱           
jam: n.拥塞之物;果酱  
janitor: n. 守卫,门警
jar: n.震惊           
jargon: n.黑话，行话       
jeer: v.嘲笑
jeopardy: n. 危险        
jester: n. 爱开玩笑的人         
jet: v.喷射,喷出
jewelry: n.珠宝        
jog: v.蹒跚行走,慢走 
jovial: a.高兴的         
jubilee: n. 纪念(佳节,欢乐)        
judiciary: a.司法的
judicious: a.有判断力的
juggler: n. 变戏法者,行骗者
jumble:n.掺杂,混杂         
juror:n. 陪审员
justify: v.证明…合理，正当       
juvenilia: n.少年读物      
juxtapose: v.并排放      
kaleidoscope: n.万花筒
keen: a.敏锐的           
kennel: n.狗窝 
Kinesiology: n. 运动机能学
kitten: n. 小猫
knob: n. 把手  
knotty: a. 有结的,多节的      
knuckle: n. 指节,蹄爪
label: v.标注      
lagoon: n.污泥潴留池     
lair: n. 野兽的巢穴
lament: v.悲伤    
lampoon: n. 讽刺文章    
landscape: n.风景  
lane: n. 小路,小巷
lark: n. 云雀,欢乐
larvae: larva(幼虫)的pl形式
lash: n.鞭子
lathe: n. 车床
laud: v.鼓掌       
laurel: n.桂冠    
lavender: n. 淡紫色,熏衣草   
lavish: a.浪费的
lax: a.松懈的
leap: v.跳跃
lease: n.租约,租用       
leash: v.束缚
legal: a.法律的      
legality: n.法律   
legend: n.传奇
legendary: a.传奇的  
legibility: n.可读
legislate: v.制定法律  
legislature: n.法律 
lemon: n. 柠檬  
lengthen: v. 延长  
leniency: n.仁慈   
lenient: a.仁慈的
leopard: n. 豹
lethal: a.致命的     
lethargic: a.昏睡的
lethargy: n.昏睡  
levee: n.大堤
lexicon: n.字典    
liability: n. 责任,债务  
liar: n.骗子 
liberate : v.解放  
lily: n. 百合花;a.纯白色的
limb: n.肢，臂，分支
limber: a.柔软的      
linger: v.犹豫      
liquefy: v.液化    
liquid: n.液体  
liter: n. 升(容量单位)
literary: a. 文学的   
livestock: n.家畜
lizard: n. 蜥蜴
loathing: n. 厌恶,憎恶   
lobby: n.大厅; v.游说
locomotive: a. 运转的,火车头的
logical: a.逻辑的    
lucid: a.清晰的      
lugubrious: a.忧伤的 
lunar: a.月亮的
lunatic: a.疯子的    
lung: n.肺
lunge: n. 刺,刺进      
lurid: a.像火烧一样的,绚丽的
luscious: a. 甘美的,浓厚的   
lustful: a.渴望的,贪婪的    
lyrical: a.抒情的    
maddening: a.使人恼火的   
magical: a.魔术的    
majesty: n.威严     
maladroit: a.笨拙的   
malady: n. 病,疾病     
malfunction: n.营养不良
malice: n.恶毒
malicious: a. 恶毒的  
malignant: a.有恶意的,恶性的   
mall: v.商场 
malleable: a.可塑的   
mallet: n.木槌,球棍
malodorous: a.恶臭的 
mammal: n.哺乳动物 
mammoth: a.巨大的
mangle: v.碾压,损坏      
marble :n. 大理石 
mare: n.母马
marine: a.海里的
marvel: n. 奇异的事物     
mascot: n. 福神,吉祥的东西
massive: a.大量的    
masterpiece: n. 杰作
Mayor : n.市长
meager: a.缺乏的    
meander: a.蜿蜒的    
mechanic: n.机械  
mechanical : a. 机械的,力学的
meddlesome: a.干扰的  
median: a.中间的,正中的     
medical: a.医学的    
medium: n.媒介
meek: a. 温顺的,谦恭的       
melodious: 音律优美的  
melody: n.韵律     
melon: n. 甜瓜
mendicant: n.乞丐  
mental: a.精神的     
mentor: n.导师     
mercy: n.可怜
mesmerizing: a.被催眠的
messy: a.混乱的      
metamorphosis: n.锐变,变质  
meteorology: n.气象学 
meticulous: a.仔细的 
metric: n.米(度量标准)
migrate: v.移动;移民
mild: a. 轻微的,温柔的
mill: n. 磨粉机,磨坊
mine: n.矿山
mineral: n.矿石
mint: n.造币厂  
minutiae: n.细节   
miser: n.守财奴,吝啬鬼
miserly: a.吝啬的
misplaced: a.放错位置的  
miter: n. 主教法冠
mitigate: v.减少,减弱   
mnemonic: a. 助记的,记忆的
moan: n. 呻吟声,悲叹声       
modest: a.谦虚的
moist: a. 潮湿的,湿润的
molding: n.模具
monarch: 独裁    
monologue: n.独白  
monotonous: a.单调的 
monster: n.怪物
moral: a.道德的      
morn: n.黎明,东方       
moronic: a. 低能的
morose: a.阴郁的     
morsel: n. 一口,少量
mortal: a.死的,致命的;n.凡人
mortality: n.死亡率;死亡   
mosaic: a.镶嵌的  
mourn: v.呻吟,哀痛       
muffle: v.消音,低沉的声音
muffler: n.消音器
multicolored: a.多种颜色的   
mundane: a.世俗的     
mural: a. 墙壁的  
murky: a.黑暗的，朦胧的，复杂的   
musical: a.音乐的;     
musty: a. 发霉的,霉臬的      
mutability: n.可变性  
mutilate: v.切断,使残缺不全    
mysterious: a.神秘的  
myth: n.神话        
mythical: a.神秘的    
nadir: n.最低点       
nail: n.钉子
naive: a.幼稚的
nap: n.打盹
napkin: n. 餐巾
nasty: a. 污秽的,下流的      
neat: a.整洁的        
needle: n.针
needy: a.急需的       
negative: a.消极的;负数的    
negligent: a.疏忽的   
neutral: a.中立的     
nibble: v.轻咬
nick: v.擦伤        
Nickel: n. 镍,镍币
nimble: a.敏捷的      
noisome: a.恶臭的     
nomination: n.提名
nonplus: v.使困惑
notorious: a.臭名昭著的   
numerology: n. 命理学
numerous: a.大量的    
nut: n.坚果
nutritious: a.有营养的  
oak: n. 橡树,橡木
oath: n.誓言        
obdurate: a. 固执的,顽固的   
obedient: a.服从的    
obese: a. 极肥胖的      
obesity: n.肥胖
object: n.物体      
obligatory: a.有义务的  
oboe: n. 双簧管
obscure: a.模糊的     
observable: a.可以观察到的  
observant: a.观察力敏锐的  
obsolete: a.过时的    
obstacle: n.障碍    
obstinacy: n.倔强
obvious: a.明显的     
oceanographer: n. 海洋学家
octagon: n. 八边形
odd: a.奇数的;奇怪的        
odious: a. 可憎的,讨厌的       
odor: n.气味       
odorless: a. 无臭的
odorous:  a. 芳香的,有气味的     
offend: v.得罪      
offensive: a.得罪人的   
olfactory: n.嗅觉器官 adj.嗅觉的 
olive: n.橄榄,橄榄树
ominous: a.预兆的,不祥的     
ooze: v.汩汩地流        
opal: n. 蛋白石,猫眼石
open-minded: a.思想开明的  
oral: a.口头的
orbit: n.轨道       
orchestra: n. 管弦乐队
ore: n.矿石
ornate: v.装饰     
ostentatious: a.虚假的 
outfit: v. 配备,供应;n.配备      
outlet: n. 出口,出路
outline: n.轮廓     
outlook: n.外貌     
outraged: a.出离愤怒的  
outwit: v.智力上超过      
oval: n. 椭圆形
oven: n. 烤炉
overcast: a. 阴天的,阴暗的
overweight: a. 超重的  
oyster: n. 牡蛎
pachyderm: n. 厚皮类迟钝的人
pacifist: n.和平爱好者   
pacify: v.平息      
pale: a.苍白的     
palette: n. 调色板,颜料  
paltry: a. 不足取的,琐碎的     
panther: n. 豹
pantomime: a.像鬼一样的
parade: n.游行,检阅
paradox: n.自相矛盾     
parallel: a.平行的     
paranoid: n.妄想狂     
parsimony: a.害怕的
passionate: a.热情的,热烈的   
pasta: n. 意大利通心粉
pathology: n.病理学
patio: n. 天井(庭院)
patron: v.资助
pause: v.暂停
peak: n.顶点         
pearl: n.珍珠
pebble: n.鹅卵石
peddle: v.沿街叫卖        
peel: n.果皮  
penguin: n. 企鹅
pentagon: n.五角形
penultimate: a. 倒数第二的  
pepper: n. 胡椒粉
perception: n.认识,观念
perceptive: adj.视角的，洞察力强的
peregrination: n. 游历,旅行
peril: v.危险,冒险        
perilous: a. 危险的
pernicious: a. 有害的,致命的
perpetuate: v.使永远   
perplex: v.复杂      
persistent: a.坚持的   
perspiration: n.流汗 
perspire: v.流汗
persuasive: a.有说服力的   
perturbation: n.打扰 
peruse: v. 熟读,精读     
perversion: n.误用
pesticide: n.杀虫剂
petite: a.小的,细的
petrified: a.石化的
petty: a.小气的
pharmacist: n.药学家 
philanthropy: n.慈善 
phobia: n.恐…的病     
pied:a. 斑驳的,杂色的        
piercing: a.刺透的    
piety: n. 虔诚       
pillar: n. 柱子
pine: n.松树  
pious: a.虔诚的
pith: n.要点
placid: a.平淡的
plain: a.平的       
plankton: n.浮游生物
plant-eating: a.植食动物 
plateau: n. 高原;平稳      
platoon: n. 排,一组
plausible: a.看上去像真实的   
playwright: n. 剧作家
plead: v. 辩护,恳求       
plentiful: a.多的   
plethora: n.过多    
pliable: a.易曲折的,柔软的
plow: n. 犁,耕地
plump: v.突然放下;突然讲出       
plunge: v.跳水,跳进      
pod: n. 豆荚
podium: n. 矮墙
poisonous: a.有毒的   
polish: v.使变光亮
pollen: n.花粉
polygon: n.多边形
pompous: a. 傲慢的,自大的     
pond: n.水池
ponder: v. 沉思,考虑      
pony: n. 小马
popcorn: n. 爆米花
porcupine: n.豪猪 
porpoise: n. 海豚
portray: v.描绘     
possessive: a.占有欲的  
posthumous: a.死后的  
postscript: n. 附笔
potable: a. 适于饮用的
potter: n. 陶工,陶艺家
pouch: n.小袋,小包  
pounce: n.猛扑
practicality: n.实际使用性
pragmatist: n.务实主义者
praiseworthy: a.值得赞扬的
prance: v.昂首阔步      
prayer: n.祈祷者         
precede: v. 在...之前,优于         
precipice: n. 断崖,绝壁
precipitation: n.沉淀;冰雹
preclude:  v. 预先排除      
predict: v.预示        
prediction: n.预示     
predominant: a.占优的    
preface: n.前序        
prehensile: a. (足等)适于抓握的     
prejudice: n.偏见      
premeditated: a. 预先想过的,预谋的   
presumption: n.假设 
pretentious: a.自负的，自命不凡的 
prevail: v.流行;胜过   
prevalent: a.流行的 
primary: a.最初的,最重要的   
primate: n.灵长类动物
primitive: a.原始的 
principal: a.原则
priority: n.优先权  
proclaim: v.宣称  
proclivity: n. 倾向,癖性  
prodigal: a.挥霍的   
productive: a.能生产的
profess: v. 声称,以...为业   
profound: a.影响深远的  
prohibit: v.禁止,阻止  
prolific: a.多产的
prolong: v.延长   
promising: a.有前景的 
prompt: v.激起;a.迅速的;n.提示    
propel: v.推动    
propensity: n.倾向性   
proprietary: n.所有权;a.专利的  
protagonist: n.主角
protractor: n. 分度器,圆规
proverb: n.格言   
providential: a. 幸运的
provincial: a.地方的,狭隘的
provoke: v.激起   
prowess: n. 英勇,勇敢
prowl: n. 潜行,徘徊     
proximity: n.接近 
prudent: a. 谨慎的   
pry: v. 打听,窥探       
psychiatric: a. 精神病的
psychology: n.心理学
publicity: n.公共性
puck: n. 圆盘
pudding: n. 布丁
puddle: n. 水池,地上积水
pulpy: a. 果肉状的,纸浆状的
punctual: a.准时的  
pungent: a. 苦痛的,刺激性的
puppy: n.小猪  
purify: v.使纯洁    
purity: n.纯正
putrid: a.腐烂的
pyramid: n.正四面体
python: n.大蟒
quadruped: n. 四足兽
quart: n.夸脱(度量单位)  
quartet: n. 四重奏
quell: v. 压制,平     
quench: v. 熄减,结束    
query: n.疑问     
quill: n.大羽毛 
quintet: n.五重奏
quirky: a. 狡诈的
quiver: n. 震动,颤抖
quotation: n.引用 
rabbit: n. 兔子
raccoon: n.浣熊
racket: n. 球拍
radiator: n. 暖气片,散热器
raft: n.斜坡;诈骗      
rainbow:彩虹
ramble:漫步，漫谈
ramp: 坡道，斜坡
rancid: a. 腐臭的
ranger: n. 守林人，骑警
ransack: v. 彻底搜索,洗劫     
rapid: a.迅速的      
rare: a.稀少的       
rarity: n. 稀薄      
rashness: n.急促   
rasp: n. 粗锉刀,擦菜板  
rational: a. 有理性的   
rattle: v.格格的响
ravenous: a.贪吃的
ravine: n.峡谷,山谷        
raze: v.消除,破坏       
razor: n. 剃刀
react: v.行动      
reaction: n.行动    
rebuttal: n. 反驳,反证    
recalcitrant: a.顽固的,反抗的 
recede: v.后退      
recess: n.休息,放假 
recessive: a.退行的   
recluse: a.隐居的;n.隐士     
recognition: n.认出;认知
recollect: v.回忆   
recur: v. 再发生        
redundant: a.丰富的   
reed: n. 芦苇
refined: a.提炼过的;有礼貌的     
refractory: a. 不听话的,执拗的  
refutation: n.拒绝  
regressive: a.退步的  
regrettable: a.后悔的 
regularity: n. 规则 
rehearsed: a. 排练的  
reimburse: v. 偿还  
reject: 拒绝     
rejection: n. 拒绝  
relaxed: v. 放松    
release: v. 释放    
religious: a. 宗教的   
rely on: 依靠     
remedy: n. 治疗      
reminisce: v. 追忆   
remote: a. 遥远的      
renaissance: n. 重生;复兴 
renew: v. 刷新       
renewal: n. 刷新     
renounce: v. 弃绝,放弃    
renovate: v. 创新    
renown: v. 出名   
rented: a. 租用的      
repel: v.排斥,反驳       
repetitious: a. 重复的   
repetitive: a. 重复的  
reprimand: v. 严厉斥责
reproach: v.斥责,责备    
reptile: n. 爬行动物 
repudiate: v. 拒绝   
repugnant: a. 讨厌的,不愉快的    
repute: n. 名望       
reserved: a. 保持的,保留的    
resign: v. 辞职,退休      
resignation: n. 辞职;逆来顺受
resilient: a. 有弹性的;愉快的   
resolution: n. 坚决 
resort to: 诉诸…   
restitution: n.赔偿 
restore: v. 恢复,归还     
restraint: n. 限制
retard: v. 延迟;妨碍      
reticent: a. 沉默的    
retraction: n.收回;取消  
retreat: v. 撤退     
retrieve: v. 取回    
revere: v. 尊敬      
reversal: n. 翻转,倒转    
revision: v. 修正,校订    
revival: n. 复兴,复活      
revolution: n. 革命  
revolutionary: a. 革命性的
revolve: v. 旋转,考虑   
rewarding: a. 报酬的 
rhinoceros: n. 犀牛;麻木不仁
rhythm: n. 韵律    
rickety: a.驼背的,摇摆的    
riddle: n.谜语    
ridicule: v. 奚落  
rifle: n.步枪;v.抢劫
rigid: a.严格的;严厉的     
rind: n.果皮  
rinse: n.洗刷
ripe: a.成熟的
ripple: n.涟漪
rivalry: n.竞争对手   
rivet: n. 铆钉;v.敲入
roam: v.漫游
robust: a.强壮的    
roe: n.鱼卵
rosy: a.玫瑰色的
rot: v. 腐烂
rotund: a.声音洪亮的    
rouse: v.升起     
route: n.路线     
royal: a. 皇家的     
rubber: n. 橡胶 
rude: a.粗鲁的      
rugby: n. 橄榄球
rumble: n. 隆隆声
runny: a. 流鼻涕的
rust: v.生锈 
ruthless: a.残忍的
sacred: a.神圣的      
saddle: n.马鞍
salmon: n.大马哈鱼
salty: a.咸的
salute: v.敬礼  
sanctioned: a.批准的 
sanguine: a.乐观的   
sanitary: a. 卫生的,清洁的
sapphire: a.蓝宝石色的
satiate: v.满足    
satire: v.讽刺     
saturate: v.渗透   
sauce: n. 调味汁,酱汁
saunter: v. 漫步,闲逛
savory: a. 风味极佳的,可口的     
saw: n.锯子
scale: n.刻度;鱼鳞  
scalpel: n.外科手术刀 
scar: n.疤痕
scarcity: n. 稀缺性   
scary: a.胆小的,害怕的
scatter: v.粉碎    
scavenger: n. 清除剂  
scent: 香气  
scheduled: a.计划好的  
school: n.鱼群
scissor: n.剪刀 
scold: v.斥责      
score: n.乐谱  
scour: n.摩擦
scrawl: n.乱涂,乱画
scream: v.惊叫      
screw: n.螺丝
screwdriver: n.扳手
scribble: v.潦草的写     
script: n.脚本,剧本
scrub: v.用力擦洗        
scrutinize: v.仔细勘察  
sculptor: n. 雕刻家
sculpture: n. 雕塑
seal: v.密封        
secondary: a.第二的;不重要的   
secrecy: n.秘密     
seep: v.渗出        
self-sufficiency: n.自给自足
sensitive: a.敏感的   
sentimental: a.多愁善感的 
sentry: n. 卫兵      
serenade: n. 夜曲    
serene: a. 宁静的      
serenity: n.宁静 
sermon: v.召集      
servile: a.奴性的 
sever: v.切断       
severe: a.严重的      
severity: n.严重性
sew: v. 缝纫,缝合         
shady: a. 荫凉的
shale: n. 页岩,泥板岩
shark: n. 鲨鱼
shave: v.刮胡子       
shepherd: n. 牧羊者
shield: n. 盾,防卫物
shiny: a.闪光的       
shivering: a. 颤抖的
shovel: n.铲子
shrill: n.尖锐的声音      
shrink: n. 收缩,萎缩      
shrub: n.灌木
shrug: v.耸肩
sidekick: v. 伙伴
sidestep: v.避开    
sidewalk: v.避开
sift: v.筛      
silly: a.傻乎乎的 
silverware: n. 银器
sincerity: n. 诚实,真实
single-handed: a. 单独一人的
skelter: v.急匆匆跑
sketch: n. 素描,草图
skimpy: a. 不足的，不够的    
skinny: a. 皮包骨头的   
skittish: a. 易激动的, 轻佻的    
skunk: n. 臭鼬鼠  
skyscraper: n. 摩天大楼
sleeve: n. 袖子
slender: a. 细长的,苗条的     
slice: : n. 薄的切片
slide rule: 计算尺
slipper: n. 拖鞋
slippery: a. 滑的    
sloppy: a.泥泞的      
slothful: a.懒惰的    
sluggish: a.懒惰的    
sly: a. 狡猾的,诡密的         
smite: v. 彻底击败       
smolder: v.闷烧,压抑
smooth: a.平静的
snack: n.吃零食
snap: v.猛咬,咬断
sneak: n.潜行       
sneaker: n.卑鄙的小人
sneaky: a. 鬼祟的,卑鄙的
sneer: v.嘲笑 
sneeze: v. 打喷嚏
snip: n. 便宜货,廉价货
snowflake: n.雪花
soak: v.浸入        
soar: v.高耸
sober: a.清醒的       
sociable: a.合群的    
solemn: a.严肃的      
solidify: v.固化    
solitary: a.孤独的     
solution: n.解决方法
somnolent: a. 想睡的,催眠的   
sonnet: n. 十四行诗
soothe: v.安慰        
soothing: a. 安慰的,安慰性的
soothsayer: n. 预言者
sophisticated: a.复杂的 
soporific: a.催眠的   
sorrow: n.悲伤      
soul: n.灵魂
sour: a. 酸的
sovereign: a. 具有主权的,至高无上的
span: n.跨度        
spare: a. 多余的,备用的       
sparrow: n. 麻雀
sparse: a.零碎的      
Spartan: a.斯巴达人     
spear: n.矛
specify: v.专门     
spectator: n. 观众,旁观者
speedometer: n. 速度计
sphere: n.球体       
spider: n.蜘蛛
spiteful: a.恶意的     
spontaneous: a.自发的;随性的  
spoon: n. 匙
sprint: n. 短距离赛跑
spruce: a.干净的,时髦的
spurious: a. 假的,伪造的
spurn: v.拒绝        
spy: v.侦探          
squirrel: n.松鼠
stadium: n.大礼堂
stagger: v.蹒跚
stain: n.污点 
stale: a.陈腐的 
stalk: v.追踪
stanza: n.诗节 
stare: v.盯
stark: a.变硬的,完全的        
startle: v.使震惊      
startled: a.震惊的
starve: v.挨饿       
stash: v.隐藏起来        
stationary: a. a. 不动的(稳定的)    
statue: n. 塑像,雕像
steadfast: a.坚定的
stem: n.树干;v.起源       
sterile: a.无菌的     
sterilize: v.使无菌
stern: a.严格的        
stew: v. 炖汤,焖   
sticky: a.粘的,粘性的       
stiff: a.直立的
stifle: v.窒息,抑制       
sting: v.叮
stingy: a. 吝啬的,小气的  
stir: v.刺激   
stoic: a.坚忍的
stomp: v.跺脚
stoop: v.弯腰,屈服     
storage: n. 储存
stout: a.强壮的,稳重的        
straighten: v.使直立   
strain: n.紧张;v.拉紧
stranded: a. 搁浅的,进退两难的     
stratum: n. 地层,阶层
straw: n. 稻草,麦杆
streak: n.斑纹
strenuous: a.奋发的,热心的     
stressed: a.紧张的     
stretcher: n. 担架
string: n.线   
striped : a. 有斑纹的
stroll: v. 闲逛,漫步
strut: v. 趾高气扬地走      
stubborn: a.笨重的     
stumble: n.v.绊倒,失策      
stun: v.惊吓         
stupid: a.愚蠢的       
stymie: v.使…处于困难境地     
subjectivity: n. 客观性
sublime: a.壮观的,卓越的
submissive: a.顺从的    
submit: v.呈递      
subside: v.平息       
substitute: n.替代品   
subterranean: a.地下的
subtle: a.细微的       
succinct: a.简洁的     
sufficient: a. 充分的
suffocate: v.窒息    
suffuse: v.充溢      
suitable: a.适合的     
summary: n.概括      
summit: n.顶点       
sumptuous: a. 高傲的     
superficial: a.表面的  
superfluous: a.多余的  
superiority: n. 优越性,优势  
supernatural: a.超自然的 
supple: a.柔软的      
surplus: a.多余的,过剩的      
surrogate: v.替代   
surround: v.围绕    
surveyor: n. 测量员
suspend: v.怀疑     
sustenance: n. 生计,食物   
swallow: v.咀嚼
swan: n.天鹅
sweltering: a. 酷热的
swindle: v.欺骗     
swollen: a.肿大的      
symbol: n.符号      
symmetrical: a.对称的
symphony: n.交响乐  
synopsis: n.大纲,概要    
taciturn: a.缄默的    
tact: n. 机智,手法  
tactile: a.有触角的  
tadpole n.蝌蚪
taint: v.污染,中毒       
talkative: a.好说的   
tally: n.标签
tame: v.驯养,驯服       
tangible: a.实体的    
tango: n. 探戈舞,其舞曲
tanned: a. 黄褐色的      
tantalizing: a.诱惑的
tapestry: n. 挂毯
tardy: a.延迟的       
tarnish: v.使失去光泽     
tattered: a. 破烂的,穿破烂衣的    
taunt: v.嘲笑       
tease: v.逗弄       
tempest: n.暴风雨
tempestuous: a. a. 有暴风雨的,暴乱的
tenacious: a. 坚忍不拔的   
tender: a.温和的,亲切的      
tepid: a.微温的
terminate: v. 结束   
terminology: n. 术语学 
terrain: n. 地带,地域     
terrestrial :a. 地上的
terrier: n. 一种活泼的小狗
terrifying: a.使人害怕的
terror: n.恐惧,战栗      
texture: n.纹理     
thermometer:n.温度计
thorough:a.彻底的    
thoughtless: a. 没有思想的
thread: n. 线 
thrifty: n. 节俭,节约
throne: n. 皇冠
thrust: n. 插入,推挤      
tidal: a. 潮流的
tile: n. 瓦片
timid: a. 胆小的        
timpani: n. 定音鼓
tiptoe: n. 脚尖
toad: n. 蟾蜍
toady: n.谄媚者
toast: n.敬酒;烤肉 
toe: n. 脚趾
tongue-tied: a. 结巴的  
torment: n.苦痛,拷问      
tornado: n.飓风 
torpid: n. 麻木
torso: n. 躯干(残缺的东西)
tortoise: n. 龟
torture: v.折磨      
toss: v.摇荡,辗转         
totalitarian: a. 极权主义者的
toxic: a.有毒的       
traitor: n.叛徒,卖国贼
tranquility: n.安静  
transform: n.转变    
transgress: v.违反法律   
transitory: a.短暂的   
transparent: a.透明的  
trapped: a. 被困的
travail: n.分娩阵痛      
treacherous: a.叛逆的,危险的  
tread: n.梯级        
trembling: a.发抖的    
tremulous: a.胆小的
trepidation: n.害怕  
triad: n.三人一组
trial: n.试验;审判
tribute: n.称赞    
trick: n.计谋     
trickery: n.计谋  
triumph: n.大胜利   
trivia: n.琐事    
trivial: a.琐碎的
trout: n. 鳟鱼
truculent: a. 凶恶的
trumpet: n.小号
truncate: v. 缩短  
trunk: n.树的躯干
trying: a.费劲的,令人厌烦的    
tub: n.浴盆
tuba: n.大喇叭
tuck: v.卷起
tug: v.拉
tumble: n.跌倒,滚动  
tumult: n. 骚动    
turtle: n. 海龟
twirl: n.扭转      
twisted: a.扭曲的   
tycoon: n.台风
typical: a.典型的   
tyranny: n.残暴
ubiquitous: a.到处都是的  
unbiased: a.有偏见的       
uncivilized: a.未开化的    
uncommitted: a.不忠的    
uncomplicated: a.不复杂的  
uncompromising: a. a不让步的,不妥协的  
underage: a. 未成年的    
undermine: 削弱 
unearth: v. 挖掘     
unethical: a. 不道德的
uneven :a.不公平的
unfaithfulness: n.不忠
unfettered: a.无拘无束的
unflinching: a.不畏惧的   
unfounded: a.没有根据   
uniformity: n.同意  
universal: a.普遍的   
unkempt: a.不整洁的     
unleavened: a. 没放酵粉的
unrealistic: a. 不现实的 
unrelated: a. 不相关的   
unrestrained: a. 不受限制的  
unruly: a.无法无天的 
untimely: a.不准时的  
update: v.更新    
upright: a. 正直的,诚实的    
uproarious: a. 喧嚣的
uproot: v.连根拔起,根除
urge: v.强调       
usurp: v. 篡夺      
utility: n.适用性    
utilize: v. 利用    
vacant: a. 空的     
vacation: n.假期 
vague: a.模糊的      
vain: a. 空的;空虚的    
valor: n.勇气      
valuable: a. 有价值的   
vane: n. 风向标
vanity: n. 空虚  
varied: a.多种多样的  
various: a. 多种多样的    
vase: n. 花瓶 
vegetarian: n. 素食主义者 
vegetation: n. 植被
vengeance: n. 复仇  
venture: n.奇迹
veracious: a. 诚实的,说真话的
verdict: v.判决
verify: v. 证明     
versatile: a.多才多艺的
verse: n. 诗歌
vessel: n.交通工具总称  
vest: n. 背心
veto: v. 投票反对       
vex: v. 激怒        
vibrate: v. 震动
victorious: a. 胜利的  
vigilant: a.机警的  
vigorous: a. 精力充沛的 
vilify: v. 诽谤
villain: n. 恶棍
vindicate: v. 复仇  
vine: n. 藤蔓
vineyard: n. 葡萄园
violate: v. 违反    
violin: n. 小提琴
virtuous: a. 技艺精湛的 
virus: n. 病毒
vivacious: a. 栩栩如生的  
void: a. 空       
volcano: n. 火山
voracious: a. 贪吃的   
vow: n. 誓约         
vulgar: a. 粗俗的
vulnerable: a. 易受攻击的  
vulture: n. 秃鹰
waddle: v.蹒跚而行     
wag: v.摇摆 
wager: n.赌注,打赌      
waist: n. 腰部 
waive: v.放弃,免除      
wan: a. 虚弱的       
wanderer: n.漫步者   
wane: v. 衰弱
wanton: n. 荡妇     
wardrobe: n.病房   
warehouse: n. 仓库  
wariness: n. 警惕   
warlike: a. 好战的    
warm-blooded: 热血的 
warmonger: n.战争贩子  
warrior: n. 战士    
waterway: n. 水路   
wax: n. 蜡    
wayward: a. 任性的    
weaponry: n.武器总称   
weary: a.疲倦的      
weathered: a. 经受住的 
weird: a. 奇怪的
whale: n. 鲸
wheel: n.车轮
whine: v. 抱怨      
whip: v. 鞭打
whisper: v. 低声;吹口哨
wicked: a. 邪恶的     
wilt: v. 枯萎
wince: v. 畏缩 
windy: a. 有风的      
winsome: a. 英俊的  
withdraw: 后退   
withered: a. 枯萎的
withhold: v.抑制   
woeful: a. 悲伤的     
woodwind: n. 木管乐器
worldly: a. 世俗的
worm: n. 蠕虫
worshipper: n. 礼拜者
woven: weave(编织)的pp   
wreath: n. 花环,花圈     
wretched: a. 可怜的   
wrinkle: n. 皱纹
wrist: n. 腕关节
yearn: n.热切期望      
yield: v.屈服,产生   
zebra: n. 斑马
zenith: n.天顶     
zipper: n.拉链
